Hello=Ahoj
Book=Kniha
Cat=Kočka
Dog=Pes
Family=Rodina
School=Škola
Good=Dobrý
Big=Velký
Sad=Smutný
Green=Zelená
Red=Červená
Yellow=Žlutá
Blue=Modrá
Purple=Fialová
Orange=Oranžová
Black=Černá
White=Bílá
Mother=Matka
Father=Otec
Brother=Bratr
Sister=Sestra
Apple=Jablko
Pear=Hruška
Friend=Kamarád
Pen=Tužka
Car=Auto
Water=Voda
Food=Jídlo
House=Dům
Tree=Strom
Sun=Slunce
Moon=Měsíc
Star=Hvězda
Chair=Židle
Table=Stůl
Window=Okno
Door=Dveře
Street=Ulice
City=Město
Country=Země
Day=Den
Night=Noc
Morning=Ráno
Evening=Večer
Love=Láska
Work=Práce
Play=Hrát
Run=Běhat
Walk=Chodit
Eat=Jíst
Drink=Pít
Sleep=Spát
Laugh=Smát(se)
Cry=Plakat
Sing=Zpívat
Dance=Tancovat
Read=Číst
Write=Psát
Listen=Poslouchat
Speak=Mluvit
Think=Myslet
Know=Vědět
See=Vidět
Hear=Slyšet
Touch=Dotknout(se)
Smile=Úsměv
Friendship=Přátelství
Family=Rodina
Game=Hra
Toy=Hračka
Money=Peníze
Time=Čas
Weather=Počasí
Hot=Horký
Cold=Studený
Rain=Déšť
Snow=Sníh
Wind=Vítr
Cloud=Mrak
Flower=Květina
Bird=Pták
Dog=Pes
Cat=Kočka
Fish=Ryba
Horse=Kůň
Cow=Kráva
Sheep=Ovce
Goat=Koza
Milk=Mléko
Bread=Chléb
Cheese=Sýr
Butter=Máslo
Egg=Vejce
Knife=Nůž
Fork=Vidlička
Spoon=Lžíce
Plate=Talíř
Cup=Hrnek
Glass=Sklenice
Bag=Torbа
Shoes=Boty
Clothes=Oblečení