Metamorphosis=Proměna
Epistemology=Epistemologie
Paradox=Paradox
Phenomenon=Fenomen
Symbiosis=Symbióza
Autonomy=Autonomie
Benevolence=Dobrosrdečnost
Conjecture=Domněnka
Dichotomy=Dichotomie
Empiricism=Empirismus
Existentialism=Existencialismus
Hegemony=Hegemonie
Idiosyncrasy=Idiosynkrazie
Ontology=Ontologie
Paradigm=Paradigma
Quintessence=Kvintesence
Soliloquy=Monolog
Synthesis=Syntéza
Transcendence=Transcendence
Ubiquity=Všemohoucnost
Veneration=Uctívání
Ambiguity=Dvojznačnost
Confluence=Splynutí
Cryptography=Kryptografie
Debilitation=Oslabení
Ebullience=Vřelost
Equanimity=Vyrovnanost
Exacerbation=Zhoršení
Felicity=Štěstí
Gratification=Uspokojení
Impetus=Podnět
Incongruity=Nepřiměřenost
Indefatigable=Neúnavný
Ineffability=Nesdělitelnost
Inscrutability=Neporozumitelnost
Interlocutor=Rozhovorový partner
Introspection=Sebereflexe
Juxtaposition=Vedlejší umístění
Labyrinth=Labyrint
Magnanimity=Velkorysost
Mellifluous=Melodický
Munificence=Štědrost
Nefarious=Zlý
Obfuscation=Zatajení
Ostentation=Okázalost
Peregrination=Cesta
Perfunctory=Povrchní
Perspicacity=Bystrost
Proclivity=Sklon
Prognostication=Předpověď
Recalcitrance=Nepoddajnost
Reverberation=Odzvuk
Sagacity=Moudrost
Salubrious=Prospěšný
Sartorial=Oděvní
Serendipity=Štěstí
Solipsism=Solipsismus
Soporific=Usínací
Subterfuge=Zákeřnost
Superfluity=Nadbytečnost
Surreptitious=Tajný
Temerity=Smělost
Tenacity=Vytrvalost
Transmutation=Přeměna
Truculence=Tvrdohlavost
Ubiquity=Všudypřítomnost
Vacillation=Kolísání
Vicissitude=Proměnlivost
Vindication=Oprávnění
Vituperation=Ostrá kritika
Volition=Vůle
Wistfulness=Zádumčivost
Zealotry=Fanatismus
Abnegation=Odříkání
Abstruseness=Složitost
Accoutrement=Výstroj
Acuity=Bystrost
Adulation=Chvála
Alacrity=Horlivost
Amelioration=Zlepšení
Anachronism=Anachronismus
Antithesis=Antiteze
Aphorism=Aforismus
Aplomb=Sebejistota
Ardor=Horlivost
Assiduity=Pilnost
Austerity=Střídmost
Cacophony=Kakofonie
Cadence=Rytmus
Capitulation=Kapitulace
Causticity=Žíravost
Chicanery=Podvod
Circumspection=Obezřetnost
Clemency=Milosrdenství
Cogitation=Úvaha
Commensurability=Poměrnost
Concomitance=Souběžnost
Conflagration=Požár
Contentiousness=Sporlivost
Conviviality=Společenskost
Corporeality=Tělesnost
Cupidity=Chamtivost
Debauchery=Rozvratnost